......^####..................
..........#..................
..........#..................
..........#..................
..........#..................
..........#..................
..###########.#######........
..#.......#.#.#.....#........
..#.....###########.#........
..#.....#.#.#.#...#.#........
..#########.#.#.#####........
........#...#.#.#.#..........
........#####.#.#.#..........
..............#.#.#..........
..............#.#.#..........
..............#.#.#..........
..............#####.......#..
................#.........#..
................#.........#..
................#.........#..
................#.........#..
................#.........#..
..........#######.........#..
..........#...............#..
..........#...............#..
..........#...............#..
..........#...............#..
..........#...............#..
#####.....#.........#######..
#...#.....#.........#........
#...#.....#.........#........
#...#.....#.........#........
#...#############...#........
#.........#.....#...#........
###########.....#.#####......
................#.#.#.#......
................#.#.#.#......
................#.#.#.#......
................#############
..................#.#.#.....#
................#####.#.....#
................#.#...#.....#
................#.###########
................#.....#......
................#######......

